,Date,Book,Particular,Debit,Credit,Balance
0,1/4/2019,,Opening Balance DR,,,"4,500.00"
1,15/02/20,SAL0,RECHARGE SALE R  1894229477,"2,000.00",,"6,500.00"
2,16/02/20,SAL0,RECHARGE SALE R  1894864624,"1,500.00",,"8,000.00"
3,17/02/20,SAL0,RECHARGE SALE R  1895179410,"1,000.00",,"9,000.00"
4,18/02/20,SAL0,RECHARGE SALE R  1895752186,500,,"9,500.00"
5,18/02/20,CSH1,CASH R.NO.,,"9,500.00",0
